! ! ! ! ! ! ! ! ! ! ! ! ! ! ! ! ! ! ! ! 
! S # # # # # # # # # # # # # # # # # ! 
! ! ! ! ! ! ! ! ! # ! ! ! ! ! ! ! ! ! ! 
! # # # # # # # # # # # # # # # # ! # ! 
! # # # # # # # # # # # # # # # # ! # ! 
! # # # # # ! # # # # # # # # # # ! # ! 
! # # # # # ! ! ! ! # # # # # # # ! # ! 
! # # # # # ! # # # # # # # # # # # # ! 
! # # # ! ! ! # ! ! ! # ! ! # # # ! # ! 
! # # # # # ! # E ! # # # # # # # ! ! ! 
! ! ! ! ! ! ! ! ! ! ! ! ! ! ! ! ! ! ! ! 

