! ! ! ! ! ! ! ! ! ! ! ! ! ! ! ! ! ! ! ! 
! S # ! # # # # # # # # # # # # # # # ! 
! # # ! # # # # # # # # # # # # # # # ! 
! # # ! # # # # # # # # # # # # # # # ! 
! # # ! # # # # # # # # # # # # # # # ! 
! # # ! # # # # # # # # # # # # # # # ! 
! # # # # # # # # # # # # # # # # # # ! 
! # # # # # # # # # # # # # # # # # # ! 
! # # # # # # # # # # # # # # # E # # ! 
! # # # # # # # # # # # # # # # # # # ! 
! ! ! ! ! ! ! ! ! ! ! ! ! ! ! ! ! ! ! ! 
