! ! ! ! ! ! ! ! ! ! ! ! ! ! ! ! ! ! ! ! 
! S # # # # # # # # # # # # # # # # # ! 
! ! ! ! ! ! ! # ! ! ! ! ! ! ! ! ! ! # ! 
! # # # # # # # # # # # # # # # # ! # ! 
! # # # # # # # # # # ! # # # # # ! # ! 
! # # # # # # # ! # # ! # # # # # ! # ! 
! # # # # # # # ! ! ! # # # # # # ! # ! 
! # # # # # # # # # # # # # # # # # # ! 
! # # # # # # # # # # # # # # # # ! # ! 
! # # # # # # # # # # # # # # # ! E # ! 
! ! ! ! ! ! ! ! ! ! ! ! ! ! ! ! ! ! ! ! 

